#########B#
#       # #
# ####### #
# #     # #
# # ##### #
# # #   # #
#     #   #
#A######### 